00011111110000000000
00000000000000000000
00101010000010000000
00101010100010000000
00101010000010000000
00101010100010000000
00101000100010000000
00001000000010000000
00001111000010000000
00000000000010000000
00000000000000000000
00000000000000000000
00000000000000000000