00011100000100000000
00000000000100000000
00101000001111111
001010000010000000
00101000000010000000
0010100000010000000
1111100000010000000
00001000000010000000
00001111000010000000
00001000000010000000
00001000000000000000
00001000000000000000
00001000000000000000